XXXXXXXXXXXXXX-XXXXXXXXXXXX-XXXX
XXXXXXXXXXXXXXXXXXXXXXXXXXXXXXXX
X-XXXXXX-XXXXXX-XXXXXXXXX-XXXX-X
XXXXXXXXXXXXXXXXXXXXXXXXXXXXXXXX
XXXXXXXXXXXXXXXXXXXXXXXXXXXXXXXX
XXXXXXXXXXXXXXXXXXXXXXXXXXXXXXXX
--------------ffff--------------
--------------------------------
--------------------------------
--------------------------------
--------------------------------
--------------P-----------------
--------------------------------
X-----XX----XfffX-X---------X--X
--------------------------------
--------------------------------
--------------------------------
XXXXXXXXXXXXXXXXXXXXXXXXXXXXXXXX
XXXXXXXXXXXXXXXXXXXXXXXXXXXXXXXX
XXXXXXXXXXXXXXXXXXXXXXXXXXXXXXXX
XXXXXXXXXXXXXXXXXXXXXXXXXXXXXXXX
XXXXXXXXXXXXXXXXXXXXXXXXXXXXXXXX
XXXXXXXXXXXXXXXXXXXXXXXXXXXXXXXX
XXXXXXXXXXXXXXXXXXXXXXXXXXXXXXXX